{
    "mazesEasy": [{
        "id": "0",
        "map": [
        [1,1,1,1,1,1,1,1,1,1,1,1,1,1,1],
        [1,2,1,1,0,0,0,0,0,1,1,0,0,0,1],
        [1,0,1,0,0,1,0,1,0,0,0,0,1,0,1],
        [1,0,0,0,1,1,0,1,0,1,1,1,1,0,1],
        [1,0,1,0,1,1,0,1,0,1,0,0,0,0,1],
        [1,0,1,0,0,0,0,1,0,0,0,1,1,0,1],
        [1,0,1,1,1,1,0,1,1,1,0,1,1,0,1],
        [1,0,0,0,0,1,0,1,0,1,0,0,0,0,1],
        [1,0,1,1,0,1,0,1,0,1,1,1,1,0,1],
        [1,0,1,1,0,0,0,0,0,1,1,0,0,0,1],
        [1,1,1,1,0,1,1,1,0,1,1,1,1,1,1],
        [1,0,0,1,0,1,0,0,0,0,0,1,0,0,1],
        [1,0,1,1,0,1,1,1,1,1,0,1,1,0,1],
        [1,0,0,0,0,0,0,0,0,1,0,0,0,3,1],
        [1,1,1,1,1,1,1,1,1,1,1,1,1,1,1]
        ]
        }
    , {
        "id": "1",
        "map": [
        [1,1,1,1,1,1,1,1,1,1,1,1,1,1,1],
        [1,0,1,0,0,0,0,1,1,1,0,0,0,0,1],
        [1,0,1,0,1,1,0,1,0,1,0,1,1,0,1],
        [1,2,1,0,1,1,0,0,0,0,0,1,1,0,1],
        [1,0,1,1,1,0,1,1,1,1,1,1,0,0,1],
        [1,0,0,0,0,0,1,0,0,0,0,0,0,1,1],
        [1,1,1,1,1,0,1,0,1,0,1,1,1,1,1],
        [1,0,0,0,0,0,0,0,1,0,0,0,0,0,1],
        [1,1,1,1,1,1,1,1,1,0,1,1,1,0,1],
        [1,0,0,0,0,0,1,0,0,0,1,0,0,0,1],
        [1,0,1,1,1,1,1,0,1,1,1,0,1,1,1],
        [1,0,1,0,0,3,0,0,1,0,0,0,1,0,1],
        [1,0,1,0,1,1,1,0,1,1,1,1,1,0,1],
        [1,0,0,0,1,0,0,0,0,0,0,0,0,0,1],
        [1,1,1,1,1,1,1,1,1,1,1,1,1,1,1]
        ]
        },
        {
        "id": "2",
        "map": [
        [1,1,1,1,1,1,1,1,1,1,1,1,1,1,1],
        [1,2,0,0,0,0,0,0,1,0,0,0,0,0,1],
        [1,1,0,1,1,0,0,1,0,1,1,0,1,0,1],
        [1,0,0,0,1,0,0,1,0,1,0,0,1,0,1],
        [1,0,1,0,1,1,1,1,0,0,0,1,1,0,1],
        [1,0,1,0,0,0,0,0,0,1,0,1,0,0,1],
        [1,1,1,0,1,1,1,1,1,1,0,1,1,1,1],
        [1,0,0,0,0,0,0,1,0,1,0,0,0,0,1],
        [1,1,0,1,1,0,1,1,0,1,1,1,1,0,1],
        [1,0,0,0,1,0,1,0,0,0,0,0,0,0,1],
        [1,1,1,0,1,0,1,0,1,1,1,0,1,0,1],
        [1,0,1,0,1,0,1,0,1,0,0,0,1,3,1],
        [1,0,1,0,1,1,1,1,1,1,1,1,1,0,1],
        [1,0,0,0,0,0,0,0,0,0,0,0,0,0,1],
        [1,1,1,1,1,1,1,1,1,1,1,1,1,1,1]
        ]
        },
        {
        "id": "3",
        "map": [
        [1,1,1,1,1,1,1,1,1,1,1,1,1,1,1],
        [1,0,0,0,0,0,0,0,0,0,0,0,0,0,1],
        [1,1,1,1,1,0,1,1,1,1,1,1,1,0,1],
        [1,0,0,0,1,2,0,0,0,0,0,1,0,0,1],
        [1,0,1,0,1,1,1,1,1,1,0,1,1,1,1],
        [1,0,1,0,1,0,0,0,0,1,0,1,0,0,1],
        [1,1,1,0,1,1,1,1,0,1,0,1,1,0,1],
        [1,0,0,0,0,0,0,1,0,0,0,0,1,0,1],
        [1,1,1,1,1,0,1,1,0,1,1,1,1,0,1],
        [1,0,0,0,0,0,1,0,0,0,0,0,0,0,1],
        [1,0,1,1,1,0,1,0,1,1,1,1,0,1,1],
        [1,0,1,3,1,0,1,0,1,0,0,0,0,0,1],
        [1,0,1,0,1,1,1,1,1,1,1,1,1,0,1],
        [1,0,0,0,0,0,0,0,0,0,0,0,0,0,1],
        [1,1,1,1,1,1,1,1,1,1,1,1,1,1,1]
        ]
        },
        {
            "id": "4",
            "map": [
        [1,1,1,1,1,1,1,1,1,1,1,1,1,1,1],
        [1,0,0,0,0,0,0,0,0,0,0,0,0,0,1],
        [1,1,0,1,1,0,1,1,1,1,1,1,1,0,1],
        [1,0,0,0,1,0,1,0,0,0,0,1,1,0,1],
        [1,0,1,2,1,1,1,0,1,1,0,1,0,0,1],
        [1,0,1,0,1,0,1,1,1,1,0,1,1,0,1],
        [1,1,1,1,1,0,0,0,0,1,0,1,1,0,1],
        [1,3,0,0,0,0,1,1,0,1,0,0,0,0,1],
        [1,1,1,1,1,0,1,1,0,1,0,1,1,0,1],
        [1,0,0,0,1,0,0,0,0,0,0,1,0,0,1],
        [1,0,1,1,1,1,1,1,1,1,1,1,0,1,1],
        [1,0,1,0,0,0,0,0,0,0,0,1,0,1,1],
        [1,0,1,0,1,1,1,1,1,1,1,1,0,1,1],
        [1,0,0,0,0,0,0,0,0,0,0,0,0,0,1],
        [1,1,1,1,1,1,1,1,1,1,1,1,1,1,1]
        ]
        }
    ],
    "mazesHard": [
        {
            "id": "0",
            "map": [
                [1,1,1,1,1,1,1,1,1,1,1,1,1,1,1,1,1,1,1,1],
                [1,3,0,0,0,0,0,0,0,1,0,0,0,0,0,0,0,0,0,1],
                [1,0,1,1,1,1,1,1,0,1,0,1,1,1,1,1,1,1,0,1],
                [1,0,1,0,0,0,0,1,0,1,0,1,0,0,0,0,0,1,0,1],
                [1,0,1,1,0,1,0,1,0,1,0,1,0,1,1,1,1,1,0,1],
                [1,0,0,0,0,1,0,1,0,1,0,1,0,0,0,0,0,0,0,1],
                [1,1,1,1,0,1,0,1,0,1,0,1,1,1,1,1,1,1,1,1],
                [1,0,0,1,0,1,0,1,0,1,0,0,0,0,0,0,0,0,0,1],
                [1,0,1,1,0,1,0,1,0,1,1,1,1,1,1,1,1,1,0,1],
                [1,0,1,0,0,1,0,1,0,0,0,0,0,0,0,0,0,1,0,1],
                [1,0,1,1,1,1,0,1,1,1,1,1,1,1,1,1,0,1,0,1],
                [1,0,0,0,0,0,0,0,0,0,0,0,0,0,0,1,0,1,0,1],
                [1,0,1,1,1,1,1,1,1,1,1,1,1,0,1,1,0,1,0,1],
                [1,0,0,0,0,0,0,0,0,0,0,0,1,0,0,0,0,1,0,1],
                [1,0,1,1,1,1,1,1,1,1,1,0,1,0,1,1,1,1,0,1],
                [1,0,0,0,0,0,0,0,0,0,1,0,1,0,1,0,0,0,0,1],
                [1,0,1,0,1,1,1,1,1,0,1,0,1,0,1,0,1,1,1,1],
                [1,0,1,0,1,0,0,0,1,0,1,0,1,0,0,0,0,0,0,1],
                [1,0,1,0,1,0,0,0,0,0,0,0,1,0,1,0,0,0,2,1],
                [1,1,1,1,1,1,1,1,1,1,1,1,1,1,1,1,1,1,1,1]
            ]
        },
        {
            "id": "1",
            "map": [
                [1,1,1,1,1,1,1,1,1,1,1,1,1,1,1,1,1,1,1,1],
                [1,0,0,0,0,0,0,0,0,0,0,0,0,0,0,0,0,0,0,1],
                [1,0,1,1,1,0,1,1,1,1,1,1,0,1,0,1,1,1,0,1],
                [1,0,1,0,0,0,0,0,0,0,0,1,0,1,0,1,0,0,0,1],
                [1,0,1,0,1,1,1,0,1,1,0,1,0,1,0,1,0,1,1,1],
                [1,0,1,0,1,0,0,0,0,1,0,0,0,1,0,1,0,0,0,1],
                [1,0,0,0,1,0,0,1,0,1,0,0,0,1,0,1,1,1,0,1],
                [1,0,1,3,1,0,1,0,0,0,0,1,0,1,0,0,0,1,0,1],
                [1,0,1,1,1,0,1,1,1,1,0,1,1,1,1,1,0,1,0,1],
                [1,0,0,0,1,0,0,0,0,0,0,1,0,0,0,0,0,1,0,1],
                [1,1,1,0,1,1,1,1,1,1,1,0,0,1,1,1,1,1,0,1],
                [1,0,0,0,0,0,0,0,0,0,0,0,0,0,0,0,0,0,0,1],
                [1,0,1,1,1,1,1,1,1,1,0,1,1,1,1,1,1,1,1,1],
                [1,0,1,0,0,0,0,0,0,1,0,1,0,0,0,0,0,0,0,1],
                [1,0,1,1,1,1,1,1,0,1,0,1,1,1,1,1,1,1,0,1],
                [1,0,0,0,0,0,0,1,0,1,0,0,0,0,0,0,0,1,0,1],
                [1,1,1,0,1,1,0,1,0,1,1,1,1,1,0,0,0,1,0,1],
                [1,0,0,0,0,1,0,1,0,0,0,0,0,0,0,1,0,1,0,1],
                [1,0,1,1,0,1,0,1,0,0,0,0,0,0,0,1,0,0,2,1],
                [1,1,1,1,1,1,1,1,1,1,1,1,1,1,1,1,1,1,1,1]
            ]
        },
        {
            "id": "2",
            "map": [
                [1,1,1,1,1,1,1,1,1,1,1,1,1,1,1,1,1,1,1,1],
                [1,0,0,0,0,0,0,0,0,0,0,0,0,0,0,0,0,0,0,1],
                [1,0,1,1,1,1,1,0,1,0,1,1,1,1,1,1,1,1,0,1],
                [1,0,1,0,0,0,1,0,1,0,1,0,0,0,0,0,0,1,0,1],
                [1,0,1,0,1,0,1,0,1,0,1,0,1,1,1,1,0,1,0,1],
                [1,0,0,0,1,0,1,0,1,0,1,0,1,0,0,1,0,1,0,1],
                [1,0,1,1,1,0,1,1,1,0,1,1,1,0,0,1,0,1,0,1],
                [1,0,0,0,1,0,0,0,1,0,0,0,1,1,0,1,0,1,0,1],
                [1,1,1,0,1,1,1,0,1,1,1,1,1,0,0,1,0,1,0,1],
                [1,0,0,0,1,0,1,0,0,0,0,0,1,1,0,1,0,1,0,1],
                [1,0,1,0,1,0,1,1,1,1,1,0,1,0,0,1,0,1,0,1],
                [1,0,1,0,0,0,1,0,0,0,1,0,1,1,0,1,0,1,0,1],
                [1,0,1,1,1,0,1,1,1,0,1,0,1,0,0,1,0,1,0,1],
                [1,0,0,0,0,0,0,0,1,0,1,0,1,1,0,1,0,1,0,1],
                [1,1,1,0,1,1,1,0,1,0,1,0,1,0,0,1,0,1,0,1],
                [1,0,0,0,0,0,1,0,0,0,1,0,1,1,0,1,0,1,0,1],
                [1,0,1,1,1,0,1,0,1,0,1,0,1,0,0,1,0,1,0,1],
                [1,0,1,3,1,0,1,0,1,0,1,0,1,1,0,1,0,1,0,1],
                [1,0,1,0,0,0,0,0,1,0,0,0,0,0,0,1,0,0,2,1],
                [1,1,1,1,1,1,1,1,1,1,1,1,1,1,1,1,1,1,1,1]
            ]
        },
        {
            "id": "3",
            "map": [
                [1,1,1,1,1,1,1,1,1,1,1,1,1,1,1,1,1,1,1,1],
                [1,3,0,0,1,0,0,0,1,0,0,0,0,0,0,0,0,0,2,1],
                [1,1,1,0,1,1,1,0,1,0,1,1,1,1,1,1,0,1,0,1],
                [1,0,0,0,0,0,1,0,1,0,1,0,0,0,0,0,0,1,0,1],
                [1,1,1,0,1,0,1,0,1,0,1,0,1,1,1,1,0,1,0,1],
                [1,0,0,0,1,0,1,0,1,0,0,0,0,0,0,1,0,1,0,1],
                [1,0,1,0,1,0,1,1,1,0,0,0,1,0,0,1,0,1,0,1],
                [1,0,1,1,1,1,1,0,1,1,0,0,1,0,0,1,0,1,0,1],
                [1,0,0,0,0,0,1,0,0,0,1,0,1,1,0,1,0,1,0,1],
                [1,1,1,1,1,0,0,0,1,0,1,0,1,0,0,1,0,1,0,1],
                [1,0,0,0,1,0,1,0,1,0,1,0,1,0,0,1,0,1,0,1],
                [1,0,1,1,1,0,1,0,1,0,1,0,1,0,0,1,0,0,0,1],
                [1,0,1,0,0,0,1,0,1,0,1,0,1,1,0,1,0,1,0,1],
                [1,0,1,0,1,1,1,0,1,0,1,0,1,0,0,1,0,1,0,1],
                [1,0,1,0,0,0,0,0,1,0,1,0,1,0,0,1,0,1,0,1],
                [1,0,1,1,1,0,1,1,1,0,0,0,1,0,0,1,0,1,0,1],
                [1,0,0,0,0,0,0,0,0,0,1,0,0,0,0,0,0,1,0,1],
                [1,0,1,1,1,1,1,1,1,1,1,0,1,0,0,1,1,1,0,1],
                [1,0,0,0,0,0,0,0,0,0,0,0,0,0,0,0,0,0,0,1],
                [1,1,1,1,1,1,1,1,1,1,1,1,1,1,1,1,1,1,1,1]
            ]
        },
        {
            "id": "4",
            "map": [
                [1,1,1,1,1,1,1,1,1,1,1,1,1,1,1,1,1,1,1,1],
                [1,0,0,0,0,0,0,0,0,0,0,0,0,1,0,0,0,0,0,1],
                [1,0,1,1,0,1,1,1,1,1,1,1,0,1,0,1,1,1,0,1],
                [1,0,1,2,0,0,0,0,0,0,0,1,0,1,0,1,0,0,0,1],
                [1,0,1,0,1,1,1,1,1,1,0,1,0,1,0,1,0,1,1,1],
                [1,0,0,0,1,0,0,0,0,1,0,1,0,1,0,1,0,0,0,1],
                [1,0,1,0,1,0,1,1,0,1,0,1,0,1,0,1,1,1,0,1],
                [1,0,1,0,1,0,1,0,0,1,0,1,0,1,0,0,0,1,0,1],
                [1,0,1,1,1,0,1,1,1,1,0,1,1,1,1,1,0,1,0,1],
                [1,0,0,0,1,0,0,0,0,0,0,1,0,0,0,0,0,1,0,1],
                [1,1,1,0,1,1,1,1,1,0,1,1,0,1,1,1,1,1,0,1],
                [1,0,0,0,0,0,0,0,0,0,0,1,0,0,0,0,0,0,0,1],
                [1,0,1,0,0,0,0,0,0,1,0,1,0,0,0,0,0,0,0,1],
                [1,0,1,1,1,1,1,1,0,1,0,1,1,1,1,0,1,1,0,1],
                [1,0,0,0,0,0,0,1,0,1,0,0,0,0,0,0,0,1,0,1],
                [1,0,1,1,1,1,0,1,0,1,1,1,1,1,1,1,0,1,0,1],
                [1,0,0,0,0,1,0,1,0,0,0,0,0,0,0,1,0,1,0,1],
                [1,1,1,1,0,1,0,1,1,1,0,1,1,1,0,0,0,1,0,1],
                [1,0,0,0,0,1,0,0,0,0,0,0,0,1,0,1,0,1,3,1],
                [1,1,1,1,1,1,1,1,1,1,1,1,1,1,1,1,1,1,1,1]
            ]
        }
    ]
}